



sct.ayrcoalnard	Ayrshire Coast Line (Ardrossan)	Ardrossan South Beach - Ardrossan Harbour
sct.ayrcoalnayr	Ayrshire Coast Line (Ayr)	Glasgow - Paisley - Ayr
sct.ayrcoalnlar Ayrshire Coast Line (Largs)	Kilwinning - Largs
sct.balbra	Balloch branch	Dumbarton - Balloch
sct.borln	Borders Line	Edinburgh - Tweedbank
sct.carln (3)	Carstairs Line	Edinburgh - Carstairs - Wishaw - Motherwell
sct.carln	Carlisle Line	Glasgow - Kilmarnock - Carlisle
sct.catcircat	Cathcart Circle (Cathcart)	Langside - Mount Florida - Kings Park
sct.catcirnei	Cathcart Circle (Neilston)	Glasgow - Mount Florida - Neilston
sct.catcirnew	Cathcart Circle (Newton)	Glasgow - Langside - Newton
sct.croyln	Croy Line	Glasgow - Croy - Edinburgh
sct.cumln	Cumbernauld Line	Glasgow - Cumbernauld - Camelon
sct.dunln	Dunblane Line	Edinburgh - Dunblane
sct.ekln	East Kilbride Line	Glasgow - East Kilbride
sct.invlngou	Invercylde Line (Gourock)	Glasgow - Gourock
sct.invlnwem	Invercylde Line (Wemyss Bay)	Port Glasgow - Wemyss Bay
sct.marln	Maryhill Line	Glasgow QS - Anniesland
sct.nclyln	North Clyde Line	Helensburgh Central - Edingburgh
sct.paicanln	Paisley Canal Line	Glasgow - Paisley Canal
sct.sholn	Shotts Line	Glasgow - Shotts - Edinburgh
sct.sprbra	Springfield branch	Bellgrove - Springburn
sct.strln	Stranraer Line	Kilmarnock - Ayr - Stranraer
sct.wcmledi	West Coast Mainline (Edinburgh)	Lockerbie - Edinburgh
sct.wcmlgla	West Coast Mainline (Glasgow)	England - Glasgow
sct.whiln	Whifflet Line	Rutherglen - Whifflet
sct.whiglnfor	West Highland Line (Fort William)	Glasgow - Mallaig
sct.whiglnoba	West Highland Line (Oban)	Crianlarich - Oban
