Intercity
GWML | Great Western Main Line | Paddington - Bath - Bristol
SWalML | South Wales Main Line | Paddington - Bristol Pkwy - Swansea
CotLn | Cotswolds Line | Paddington - Oxford - Worcester - Hereford
GolVlyLn | Golden Valley Line | Paddington - Gloucester - Cheltenham
BerHanLn | Berks & Hants Line | Paddington - Bedwyn - Westbury - Exeter
SDML | South Devon Main Line | Paddington - Exeter - Penzance

Electrics
HEx | Heathrow Express | Paddington - Terminal 5
ThaVlyLn | Thames Valley Line | Paddington - Didcot

Thames branches
GreBraLn | West Ealing - Greenford
WinBraLn | Slough - Windsor
MarBraLn | Maidenhead - Marlow
RegLn | Regatta Line | Tywford - Henley
NDowLn | North Downs Line | Reading - Gatwick
BruLn | Brunel Line | Reading - Basingstoke
KenVlyLn | Kennet Valley Line | Reading - Newbury
OxfCanLn | Oxford Canal Line | Didcot - Banbury

Wessex branches
WesML | Wessex Main Line | Cardiff - Portsmouth
HeaWesLn | Heart of Wessex Line | Bristol - Weymouth
SevBeaLn | Severn Beach Line | Bristol - Severn Beach
TraWilLn | Trans-Wilts Line | Swindon - Westbury
CorML | Cornish Main Line | Cardiff - Penzance
SevLn | Severnside Line | Malvern - Weston

Devon & Cornwall branches
TarLn | Tarka Line | Exeter Central - Barnstaple
DarLn | Dartmoor Line | Exeter St Davids - Okehampton
AvoLn | Avocet Line | Exmouth - Exeter
RivLn | Riveria Line | Exeter - Paignton
TamVlyLn | Tamar Valley Line | Plymouth - Gunnerslake
LooeVlyLn | Looe Valley Line | Liskeard - Looe
AtlCoaLn | Atlantic Coast Line | Par - Newquay
MrtLn | Maritime Line | Truro - Falmouth
SIBLn | St Ives Bay Line | St Erth - St Ives
