Woolwich line	Cannon Street - Greenwich - Woolwich - Slade Green - Bexleyheath - Cannon Street
North Kent line	Cannon Street - Lewisham - Woolwich - Dartford - Gravesend
Bexleyheath line	Victoria - Bexleyheath - Dartford
Sidcup line	Charing Cross - Sidcup - Dartford - Gravesend
	+ Lewisham	Charing Cross - Lewisham - Sidcup - Dartford
Hayes line	Charing Cross - Lewisham - Hayes
Mid Kent line	Charing Cross - Hayes
Grove Park line	Cannon Street - Orpington
	+ Lewisham	Charing Cross - Lewisham - Orpington - Sevenoaks
Bromley North line	Grove Park - Bromley North
Bromley South line	Victoria - Bromley South - Orpington
Sole Street line	Victoria - Swanley - Gillingham
Chatham Main Line	Victoria - Chatham - Dover
	
Maidstone East line	Charing Cross - Swanley - Maidstone East
Kent Downs line	Victoria - Swanley - Maidstone East - Ashford
Paddock Wood Line	Charing Cross - Tonbridge - Ashford - Dover
South East Main Line	Charing Cross - Tonbridge - Ashford - Ramsgate
Hastings Line	Charing Cross - Tonbridge - Hastings
Medway Valley Line	Paddock Wood - Strood
Swale Line	Sheerness - Sittingbourne

Creative Coast Line	Victoria - Ramsgate
White Cliffs Line	St Pancras - Dover - Ramsgate
Kent Coast Line	St Pancras - Gillingham - Ramgate
Canterbury West Line	St Pancras - Canterbury - Margate